A	AH
A(2)	EY
ABSTRACT	AE B S T R AE K T
ATTECHRISE	AE T AH K R AY Z
B	B IY
BROWSER	B R AW Z ER
C	S IY
CATS	K AE T S
CLOSE	K L OW S
CLOSE(2)	K L OW Z
D	D IY
DOC	D AA K
E	IY
EIGHT	EY T
EMINEM	IH M AH N EH M
F	EH F
FIFA	F IH F AH
FIVE	F AY V
FOUR	F AO R
G	JH IY
GOOGLE	G UW G AH L
J	JH EY
K	K EY
M	EH M
NINE	N AY N
ONE	W AH N
ONE(2)	HH W AH N
OPEN	OW P AH N
P	P IY
S	EH S
SEARCH	S ER CH
SEVEN	S EH V AH N
SIX	S IH K S
STAN	S T AE N
T	T IY
TEN	T EH N
THREE	TH R IY
TWO	T UW
X	EH K S
